0 0 r r 0 r r 0 r r r
0 0 0 r r t 0 r 0 1 r
0 0 0 0 0 0 0 0 0 r r
0 0 t 0 0 1 0 0 0 0 p
0 0 t r r 0 0 0 r 0 1
0 0 r t f 0 0 r 0 r 0
0 0 1 0 0 r r 0 r 1 r

